NO ./assets/sprites/bird.xpm
SO ./assets/sprites/grayfox.xpm
EA ./assets/sprites/tony.xpm
WE ./assets/sprites/guts.xpm
F 220,100,0
C 225,30,0

11111111111111
10000000000001
10000000000001
10000000000001
10000000000001
10000000000001
10000000000001
10000000000001
10000000000001
10000000000001
10000000000001
10000000000001
10000000000001
10000000000001
10000000000001
10000000000001
10000000000001
10000000000001
1000000000N001
10000000000001
11111111111111
