NO ./assets/sprites/bird.xpm
SO ./assets/sprites/grayfox.xpm
EA ./assets/sprites/tony.xpm
WE ./assets/sprites/guts.xpm
F 255,255,255
C 0,0,0

11111111111111
1N000000000001
10000000000001
10000000000001
10000000000001
10000000000001
10000000000001
10000000000001
10000000000001
10000000000001
10000000000001
10000000000001
10000000000001
10000000000001
10000000000001
10000000000001
10000000000001
10000000000001
10000000000001
10000000000001
11111111111111
