NO ./assets/sprites/bird.xpm
SO ./assets/sprites/grayfox.xpm
EA ./assets/sprites/tony.xpm
WE ./assets/sprites/guts.xpm
F 110,100,0
C 111,10,0

111111111111111111111111
100000000000000000000001
10W000000000000000000001
100000000000000000000001
100000111110000101010001
1000001   1000000000000111111111111111
1000001   10000100010000000000000000001
1000001   100000000000000000001111111111
10000011111000010101000000000000000000001
10000000000000000000000111111111111111111
100000000000000000000001
100000000000000000000001
100000000000000000000001
100000000000000000000001
100000000000000000000001
100000000000000000000001
111111111000000000000001
110100001000000000000001
110000101000000000000001
110100001000000000000001
110111111000000000000001
110000000000000000000001
111111111000000000000001
111111111111111111111111
